--------------------
--  -  - ?- --+-   -
--   ?-^-  - ^  ?  -
-  --   ---  --    ?
-  +  -- +- -?-    ?
- ?-- --  -- +-    -
--   -  - -+ -     -
-    ?-  - -  +-  +-
--  -         -    -
- *     --  - -    -
-- +-  +   -  -  ? -
--      -?- -- -   -
--   ?-^-   -+ +- +-
-  --  - +    -    -
-     -- +- - -    -
- ? - --   -- -    -
--      ---        -
^   ?- -- -  ^-    -
--  -   -    ?-    -
-------^+-----------
