--------------------
--------------------
--                --
--x-----------------
-- -----------------
-- -----------------
--       +----------
-- -----------------
--*!----------------
--------------------