--------------------
----------!---------
--                --
-- ------ ----------
-- ------ -----i----
--       x          
-- --+      +-------
--                  
--+---- ---+--+ ----
-- ---- --- --  ----
--              ----
--*-----------------
--------------------