~~~~~==========~~~~~
----------!---------
--                --
-- --+--- -+g- -----
-- ---+-- --+- -----
--                 -
-- --+      +-------
--               x--
--*-----------------
--------------------
--------------------
--------------------
--------------------