--------------------
--------------------
--                 -
--x-----------------
-- -----------------
-- -----------------
--!       +---------
-- ----------------
--*-----------------
--------------------