=========================
==============~==========
====~====================
============~============
=========x===============
=======~=================
=========================
-------------------------
==*====!====~~===========
===========g=============
=========================
=========================
=========================