-------------------------
-------------------------
--                 ------
--x----------------------
-- ----------------------
-- ----------------------
--!       +--------------
-- ---------------------
--*----------------------
-------------------------
=========================
=========================
=========================