--------------------
---------!----------
====~===========~===
=~==========~=======
==~==~*=======~===~=
=c=====~============
~~=======~======~===
===~================
===~==x====~~=======
=~============~=====
~~~~~~~~~~~~~~~~~~~~