--------------------
----------!---------
--                --
--x------ ----------
-- ------ -----g----
--                  
-- --+      +-------
--                  
--*-----------------
--------------------
====================
====================
====================