-------------------------
-------------------------
--                -------
--x----------------------
-- ----------------------
-- ----------------------
--       +---------------
-- ----------------------
--*!---------------------
-------------------------
=========================
=========================
=========================