--------------------
--  -  - ?- --+-   -
--   ?-^-  - ^  ?  -
-  --   ---  --    ?
-  +  -- +- -?-    ?
- ?-- --  -- +-    -
--   -  - -+ -     -
-    ?-  - -  +-  +-
--  -         -    -
- *     --  - -    -