----!---!----!---!--
-~~~=~~~=~~~~=~~~=~-
-~~~=~~~=~~~~=~~~=~-
-~~~=~~~=~~~~=~~~=~-
-~~~#~~~#~~~~#~~~#~-
-==================-
-====~~============-
-==============~~==-
-=~~====~~===~~====-
-=======p==========-
-===~~============~~-
-=======#==========-
--------------------