--------------------
---------!----------
====~===========~===
=~==========~=======
==~==~p=======~===~=
=c=====~============
~~=======~======~===
===~================
===~==#====~~=======
=~============~=====
~~~~=~==~~~=~~~~=~~~
~~=~~==~~=~~=~~=~~~~
~~~~=~~~=~~~~=~~~=~~