----!---!----!---!--
-~~~=~~~=~~~~=~~~=~-
-~~~=~~~=~~~~=~~~=~-
-~~~=~~~=~~~~=~~~=~-
-~~~#~~~#~~~~#~~~#~-
-==================-
-==================-
-==================-
-=======~~===~~====-
-=======p==========-
-==================-
-=======#==========-
--------------------