--------------------
----------!---------
--                --
--x------ ----------
-- ------ -----l----
--                  
-- --+      +-------
--                  
--*-----------------
--------------------
--------------------
--------------------
--------------------